╔════════════╗╔════════════╗
║            ║║            ║
║ ╔══╗ ╔═══╗ ║║ ╔═══╗ ╔══╗ ║
║ ║  ║ ║   ║ ║║ ║   ║ ║  ║ ║
║ ╚══╝ ╚═══╝ ╚╝ ╚═══╝ ╚══╝ ║
║                          ║
║ ╔══╗ ╔╗ ╔══════╗ ╔╗ ╔══╗ ║
║ ╚══╝ ║║ ╚══╗╔══╝ ║║ ╚══╝ ║
║      ║║    ║║    ║║      ║
╚════╗ ║╚══╗ ║║ ╔══╝║ ╔════╝
     ║ ║╔══╝ ╚╝ ╚══╗║ ║
     ║ ║║          ║║ ║
     ║ ║║          ║║ ║
═════╝ ╚╝          ╚╝ ╚═════
                            
═════╗ ╔╗          ╔╗ ╔═════
     ║ ║║          ║║ ║
     ║ ║║          ║║ ║
     ║ ║║ ╔══════╗ ║║ ║
╔════╝ ╚╝ ╚══╗╔══╝ ╚╝ ╚════╗
║            ║║            ║
║ ╔══╗ ╔═══╗ ║║ ╔═══╗ ╔══╗ ║
║ ╚═╗║ ╚═══╝ ╚╝ ╚═══╝ ║╔═╝ ║
║   ║║                ║║   ║
╚═╗ ║║ ╔╗ ╔══════╗ ╔╗ ║║ ╔═╝
╔═╝ ╚╝ ║║ ╚══╗╔══╝ ║║ ╚╝ ╚═╗
║      ║║    ║║    ║║      ║
║ ╔════╝╚══╗ ║║ ╔══╝╚════╗ ║
║ ╚════════╝ ╚╝ ╚════════╝ ║
║                          ║
╚══════════════════════════╝
